# Map file for tile-based game
# (Lines that start with '#' are comments)
# The tiles are:
#   (Space) Empty tile
#   A..Z    Tiles A through Z
#   o       Star
#   *       Goal
#   1       Bad Guy 1 (Skeleton)

BF          o o o                o o o o o o o o o o o o o o o o o o o o o o o                EB
AD         IIIIIII              IIIIIIIIIIIIIIIIIIIIIIIIIIIIIIIIIIIIIIIIIIIIIII               CA
AD                      o o o                I                   EBBBBBBBBBBBBBF     o o o o  CA
AD                     IIIIIII               I                   CAAAAAAAAAAAAAD    o o o o o CA
AD                                           I             o o   CAAAAAAAAAAAAAHF    o o o o  CA
AD                                                        IIIII  CAAAAAAAAAAAAAAD   o o o o o CA
AD                      IIIII                                    CAAAAAAAAAAAAAAHF   IIIIIII  CA
AD         III                          1    1  1          75556 CAAAAAAAAAAAAAAAD  o o o o o CA
AD                            1      IIIIIIIIIIIII         94448 CAAAAAAAAAAAAAAAHF  o o o o  CA
AD      1       EBBBBBBBBBBBBBBBF     o o o o o o          93*38 CAAAAAAAAAAAAAAAAD o o o o o CA
AHBBBBBBBBBBBBBBGAAAAAAAAAAAAAAAHBBBBBBBBBBBBBBBBBBBBBBBBBBBBBBBBGAAAAAAAAAAAAAAAAHBBBBBBBBBBBGA